[
  {
    "map": [
        [1, 1, 0, 0, 0, 0, 0, 0],
        [1, 1, 0, 0, 0, 0, 0, 0],
        [0, 0, 0, 0, 0, 0, 0, 0],
        [0, 0, 0, 9, 9, 0, 0, 0],
        [0, 0, 0, 9, 9, 0, 0, 0],
        [0, 0, 0, 0, 0, 0, 0, 0],
        [0, 0, 0, 0, 0, 0, 5, 5],
        [0, 0, 0, 0, 0, 0, 5, 5]
    ],
    "white_winning_position": [
        [6, 6], [6, 7], [7, 6], [7, 7]
    ],
    "black_winning_position": [
        [0, 0], [0, 1], [1, 0], [1, 1]
    ]
  }
]
